25
4  2  2  2  2  2  2  2  2  2 12  2  2  2 12  2  2  2  2  2  2  2  2  2  5 
3  0  0  0  0  0  0  0  0  0  3  0  0  0  3  0  0  0  0  0  0  0  0  0  3 
3  0  4  2  2  2  5  0 11  0  8  0 11  0  8  0 11  0  4  2  2  2  5  0  3 
3  0  3  0  0  0  3  0  3 16  0  0  3  0  0 16  3  0  3  0  0  0  3  0  3 
3  0  7  2  2  2  6  0  7  2 10  0  3  0  9  2  6  0  7  2  2  2  6  0  3 
3  0  0  0  0  0  0  0  0  0  0  0  3  0  0  0  0  0  0  0  0  0  0  0  3 
7  5  0  4  2 12 12 10  0  4  2 12 15  2 12 10  0  9 12  2 12 12 10  0  3 
4  6  0  8  0  7 14  0  0  8  0  3  0 16  3  0  0  0  3  0  7  6  0  0  3 
3  0  0  0  0  0  8  0  0 99  0  8  0  9 15 10  0  9  6  0  0  0  0  0  3 
3  0 11  0 11  0  0  0 99 99 99  0  0  0  0  0  0  0  0  0 11  0 11  0  3 
3  0  3  0  7  2 10  0 11 90 11  0  0  0 11  0 11  0  9  2  6  0  3  0  3 
3  0  3  0  0  0  0  0  3 92 13  2  5  0  3  0  3  0  0  0  0  16 3  0  3 
3  0  7  2  2 10  0  9 14 91  3  0  8  0  7  2  6  0  9  2  2  2  6  0  3 
3  0  0  0  0  0  0  0  3 93  3  0  0  0  0  0  0  0  0  0  0  0  0  0  3 
7  2  2  2  2  2  2  2 15  2 15  2  2  2  2  2  2  2  2  2  2  2  2  2  6 
