4  2  2  2  2  2  2  2  2  2  2  2 12  2  2  2  2  2  2  2  2  2  2  2  5 
3  0  0  0  0  0  0  0  0  0  0  0  3  0  0  0  0  0  0  0  0  0  0  0  3 
3  0  4  2  2 10  0  9  5  0  4  2 14  0 11  0  4 10  0  9  2  2  5  0  3 
3  0  3 91 99  0  0  0  3  0  3  0  8  0  3  0  3  0  0  0 99 90  3  0  3 
3  0  3 99 11  0 11  0  3  0  8  0  0  0  8  0  3  0 11  0 11 99  3  0  3 
3  0  3  0  8  0  8  0  3  0  0  0  0  0  0  0  3  0  8  0  8  0  3  0  3 
3  0  8  0  0  0  0  0 13  2 12 10  0  4  2  2  6  0  0  0  0  0  8  0  3 
3  0  0  0  0  0 11  0  3  0  3  0  0  3  0  0  0  0  4  2  5  0  0  0  3 
3  0 11  0 11  0  7  2  6  0  8  0  9  6  0  0  9  2  6 16  3  0 11  0  3 
3  0  7  2 14  0  0  0  0  0  0  0  0  0  0  0  0  0  0  0  3  0  3  0  3 
3  0  0 99  7  2  2  2 10  0  0 11  0  0  9 12  2 10  0  9  6 99  3  0  3 
3  0 11 92 99  0  0  0  0  0  4 15  5  0  0  3  0  0  0  0 99 93  3  0  3 
3  0  7 10  0  9  2  2 10  0  3 99  3  0  9 15 12  2  2 10  0  9  6  0  3 
3  0  0  0  0  0  0  0  0  0  3 99  3  0  0  0  3  0  0  0  0  0  0  0  3 
7  2  2  2  2  2  2  2  2  2 15  2 15  2  2  2 15  2  2  2  2  2  2  2  6 
