25
4  2  2  2  2  2  2 12  2 12  2 12  2  2  2  2  2  2  2  2  2  2  2  2  5 
3  0  0  0  0  0  0  8  0  8  0  8  0  0  0  0  0  0  0  0  0  0  0  0  3 
3  0  4  2  5  0  0  0  0  0  0  0  0 11  0 11  0  9 12  2 12  2  5  0  3 
3  0  3  0  3  0  4  2  5  0 11  0  0  3  0  3  0  0  3 16  3 16  3  0  3 
3  0  3  0  3  0  3 16  3  0  3  0  0  3  0 13 10  0  3  0  3  0  3  0  3 
3  0 13  2 14  0  3  0  3  0  3  0  4 14  0  3  0  0  3  0  8  0  3  0  3 
3  0  3  0  3  0  3  0  3 16  3  0 13 14  0  3  0  9  6  0  0  0  8  0  3 
3  0  8  0  8  0  8  0  7  2  6  0  7  6  0  3  0  0  0  0 11  0  0  0  3 
3  0  0  0  0  0  0  0  0  0  0  0  0  0  0 13 10 99 11  0  3  0 11  0  3 
3  0  4  2 10  0  4  2  5  0 11  0  0 11  0  3 92 90  7  2 15  2  6  0  3 
3  0  3  0  0  0  3  0  3  0  3  0  0  3  0  3 93 91 99  0  0  0  0  0  3 
3  0  3  0  0  0  3  0  3  0  3  0  4 14  0 13  2  2  2 12  2 10  0  9 14 
3  0  8  0 11  0  7  2  6  0  8  0  7  6  0  8  0  0  0  8  0  0  0  0  3 
3  0  0  0  3  0  0  0  0  0  0  0  0  0  0  0  0 11  0  0  0 11  0  0  3 
7  2  2  2 15  2  2  2  2  2  2  2  2  2  2  2  2 15  2  2  2 15  2  2  6 
