4   2  2  2 12  2 12  2  2  2  2  2  2  2  2  2  2  2 12  2 12  2  2  2  5 
3   0  0  0  8  0  8  0  0  0  0 99 99 99  0  0  0  0  8  0  8  0  0  0  3 
3   0  0  0  0  0  0  0  4  2 12 10 90 11  0  0 11  0  0  0  0  0  0  0  3 
3   0  0  4  2  5  0  0  3  0  3 93 92  3  0  0 13 10  0  9  2  5  0  0  3 
13 10  0  3 16  3  0  9  6  0  7  5 91  3  0  0  3  0  0  0 16  3  0  9 14 
3   0  0  8  0  8  0  0  0  0  0  7  2  6  0  0  8  0  4 10  0  8  0  0  3 
13 10  0  0  0  0  0 11  0 11  0  0  0  0  0  0  0  0  3  0  0  0  0  9 14 
3   0  0  9  2  5  0  7  2 15  2  2  2  2  2  2  2  2 15 12  2 10  0  0  3 
13 10  0  0  0  3  0  0  0  0  0  0  0  0  0  0  0  0  0  3  0  0  0  9 14 
3   0  0 11  0  8  0 11  0 11  0  0  0  0  0 11  0 11  0  8  0 11  0  0  3 
13 10  0  3  0  0  0  3  0  3  0 11  0 11  0  3  0  3  0  0  0  3  0  9 14 
3   0  0  7  2 10  0  3  0  3  0  3  0  3  0  3  0  3  0  9  2  6  0  0  3 
3   0  0  0  0  0  0  3  0  3  0  3  0  3  0  3  0  3  0  0  0  0  0  0  3 
3   0  0  0 11  0  0  3 16  3  0  3  0  3  0  3 16  3  0  4  5  0  0  0  3 
7   2  2  2 15  2  2 15  2 15  2 15  2 15  2 15  2 15  2 15 15  2  2  2  6 
