25
 4   2   2   2   2   2   2   2   2   2   2   2   2   2   2   2   2   2   2   2   2   2   2   2   5 
 3   0   0   0   0   0   0   0   0   0   0   0   0   0   0   0   0   0   0   0   0   0   0   0   3 
 3   0   4  10   0   9   2   2   2   2   2   2   2   2   2   2   2   2   2  10   0   9   5   0   3 
 3   0   8   0   0   0   0   0   0   0   0   0   0   0   0   0   0   0   0   0   0   0   8   0   3 
 3   0   0   0   4   2  10   0   9   2   2   2   2   2   2   2  10   0   9   2   5   0   0   0   3 
 3   0  11   0   3   0   0   0   0   0   0   0   0   0   0   0   0   0   0   0   3   0  11   0   3 
 3   0   3   0   8   0   4   2   2  10   0   9   2  10   0   9   2   2   5   0   8   0   3   0   3 
 3   0   3   0   0   0   3   0   0   0   0   0   0   0   0   0   0   0   3   0   0   0   3   0   3 
 3   0   3   0  11   0   3   0   4   2   2  10   0   9   2   2   5   0   3   0  11   0   3   0   3 
 3   0   3   0   3   0   8   0   3   0   0   0   0   0   0   0   3   0   8   0   3   0   3   0   3 
 3   0   3   0   3   0   0   0   3   0   4  10   0   9   5   0   3   0   0   0   3   0   3   0   3 
 3   0   3   0   3   0  11   0   8   0   3   0   0   90   3   0   8   0  11   0   3   0   3   0   3 
 3   0   3   0   3   0   3   0   0   0   3   0  11   91   3   0   0   0   3   0   3   0   3   0   3 
 3   0   3   0   3   0   3   0  11   0   3   0   3   92   3   0  11   0   3   0   3   0   3   0   3 
 3   0   3   0   3   0   3   0   3   0   3   0   3   93   3   0   3   0   3   0   3   0   3   0   3 
 3   0   3   0   3   0   3   0   3   0   3   0   3   0   3   0   3   0   3   0   3   0   3   0   3 
 3   0   3   0   3   0   3   0   8   0   3   0   3   0   3   0   8   0   3   0   3   0   3   0   3 
 3   0   3   0   3   0   3   0   0   0   3   0   8   0   3   0   0   0   3   0   3   0   3   0   3
 3   0   3   0   3   0   8   0  11   0   3   0   0   0   3   0  11   0   8   0   3   0   3   0   3 
 3   0   3   0   3   0   0   0   3   0   7  10   0   9   6   0   3   0   0   0   3   0   3   0   3 
 3   0   3   0   3   0  11   0   3   0   0   0   0   0   0   0   3   0  11   0   3   0   3   0   3 
 3   0   3   0   8   0   3   0   7   2   2   2   2   2   2   2   6   0   3   0   8   0   3   0   3 
 3   0   3   0   0   0   3   0   0   0   0   0   0   0   0   0   0   0   3   0   0   0   3   0   3 
 3   0   3   0  11   0   7   2   2  10   0   9   2  10   0   9   2   2   6   0  11   0   3   0   3 
 3   0   8   0   3   0   0   0   0   0   0   0   0   0   0   0   0   0   0   0   3   0   8   0   3 
 3   0   0   0   7   2  10   0   9   2   2   2   2   2   2   2  10   0   9   2   6   0   0   0   3 
 3   0  11   0   0   0   0   0   0   0   0   0   0   0   0   0   0   0   0   0   0   0  11   0   3 
 3   0   7  10   0   9   2   2   2   2   2   2   2   2   2   2   2   2   2  10   0   9   6   0   3 
 3   0   0   0   0   0   0   0   0   0   0   0   0   0   0   0   0   0   0   0   0   0   0   0   3 
 7   2   2   2   2   2   2   2   2   2   2   2   2   2   2   2   2   2   2   2   2   2   2   2   6 
