4  2  2  2  2  2  2  2  2  2  2  2  2  2  2  2  2  2  2  2  2  2  2  2  5 
3  0  0  0  0  0  0  0  0  0  0  0  0  0  0  0  0  0  0  0  0  0  0  0  3 
3  0  9  2  2  5  0  9  2  2  2  5  0  4  5  0  9  2  2  5  0  4  5  0  3 
3  0  0  0  0  3  0  0  0  0 16  3  0 13 14  0  0  0  0  3  0 13 14  0  3 
3  0  0 11  0  3  0 11  0 11  0  3  0 13 14  0  0 11  0  3  0 13 14  0  3 
3  0  0  8 99  3  0  3  0  3  0  3  0 13 14  0  0  8 99  3  0 13 14  0  3 
3  0  0 99 90  3  0  3  0  3  0  3  0 13 14  0  0 99 92  3  0 13 14  0  3 
3  0  4  2  2  6  0  3  0  3  0  3  0 13 14  0  9  2  2 14  0 13 14  0  3 
3  0  3  0  0  0  0  3  0  3  0  3  0 13 14  0  0  0  0  3  0 13 14  0  3 
3  0  3  0 11  0  0  3  0  3  0  3  0 13 14  0  0 11  0  3  0  7  6  0  3 
3  0  3 99  8  0  0  3  0  8  0  8  0 13 14  0  0  8 99  3  0  0  0  0  3 
3  0  3 93 99  0  0  3 16  0  0  0  0 13 14  0  0 99 91  3  0  4  5  0  3 
3  0  7  2  2 10  0  7  2  2  2 10  0  7  6  0  9  2  2  6  0  7  6  0  3 
3  0  0  0  0  0  0  0  0  0  0  0  0  0  0  0  0  0  0  0  0  0  0  0  3 
7  2  2  2  2  2  2  2  2  2  2  2  2  2  2  2  2  2  2  2  2  2  2  2  6 
