25
 4   2   2   2  12  12   2   2   2   2   2   2   2   2   2   2   2   2   2   2   2   2   2   2   5 
 3   0   0   0   7   6   0   0   0   0   0   0   0   0   0   0   0   0   0   0   0   0  90  91   3 
 3   0  11   0   0   0   0  11   0  11   0   4   2  12   2   2  10   0   9   5   0  11  92  93   3 
 3   0  13   5   0   4   2  14   0   8   0   8   0   3   0   0   0   0   0   3   0   7   2   2  14 
 3   0   7   6   0   8   0   3   0   0   0   0   0   3   0  11   0  11   0   3   0   0   0   0   3 
 3   0   0   0   0   0   0   8   0   9   2  10   0   8   0   8   0   8   0  13  10   0  11   0   3 
 3   0   9  12   2   5   0   0   0   0   0   0   0   0   0   0   0   0   0   8   0   0   3   0   3 
 3   0   0   8   0   8   0   4   2  10   0   9   2  12   2   2   2  10   0   0   0   9   6   0   3 
 3   0   0   0   0   0   0   3   0   0   0   0   0   3   0   0   0   0   0  11   0   0   0   0   3 
 3   0   4   5   0  11   0   3   0   9   2   5   0   8   0   9   2   5   0   7   2   2  10   0   3 
 3   0   7   6   0   8   0   3   0   0   0   3   0   0   0   0   0   3   0   0   0   0   0   0   3 
 3   0   0   0   0   0   0   3   0   9   2   6   0   4   2   5   0   3   0   4   2  10   0   0   3 
 3   0  11   0  11   0   0   3   0   0   0   0   0   3   0   8   0   3   0   3   0   0   0   9  14 
 3   0  13   2  15  10   0  13   2   5   0   9   2   6   0   0   0   3   0   8   0  11   0   0   3 
 3   0   3   0   0   0   0   3   0   3   0   0   0   0   0  11   0   3   0   0   0   7  10   0   3
 3   0   8   0   9  10   0   3   0   8   0   9   2  10   0   3   0   3   0  11   0   0   0   0   3 
 3   0   0   0   0   0   0   3   0   0   0   0   0   0   0   8   0   3   0   8   0   9  10   0   3 
 3   0  11   0   9  10   0   3   0   4  10   0   9   5   0   0   0   3   0   0   0   0   0   0   3 
 3   0   3   0   0   0   0   3   0   3   0   0   0   3   0  11   0   3   0   9   2  12  10   0   3 
 3   0   7  12   2  10   0   3   0   3   0  11   0   3   0   8   0   3   0   0   0   8   0   0   3 
 3   0   0   3   0   0   0   3   0   8   0   8   0   8   0   0   0   3   0  11   0   0   0   9  14 
13  10   0   8   0  11   0   3   0   0   0   0   0   0   0  11   0   3   0   7   2  10   0   0   3 
 3   0   0   0   0   3   0   7   2   2   2   2   2   2   2  15   2   6   0   0   0   0   0   9  14 
 3   0  11   0   9  14   0   0   0   0   0   0   0   0   0   0   0   0   0  11   0  11   0   0   3 
 3   0   3   0   0  13   2  12  10   0   9  10   0  11   0   9  12  10   0   8   0   8   0   9  14 
 3   0  13  10   0   8   0   8   0   0   0   0   0   3   0   0   3   0   0   0   0   0   0   0   3 
 3   0   3   0   0   0   0   0   0   4   2  10   0   3   0   9   6   0  11   0   9   2   5   0   3 
 3   0   8   0  11   0   4  10   0   8   0   0   0   8   0   0   0   0   3   0   0   0   8   0   3 
 3   0   0   0   3   0   3   0   0   0   0  11   0   0   0  11   0   4  14   0  11   0   0   0   3 
 7   2   2   2  15   2  15   2   2   2   2  15   2   2   2  15   2  15  15   2  15   2   2   2   6 

