25
4  2  2  2  2  2  2  2  2  2  2  2  2  2  2  2  2  2  2  2  2  2  2  2  5 
3  0  0  0  0  0  0  0  0  0  0  0  0  0 99 99 99 99 99 99  0  0  0  0  3 
3  0  4  2  5  0  4  2  5  0  4  2  5  0 11 93 92 90 91 4  5  0  11  0  3 
3  0  8  0  3  0  8  0  3  0  8  0  3  0  7  2 12  2  2 15 14  0  8  0  3 
3  0  0  0  3  0  0  0  3  0  0  0  3  0  0  0  3  0  0  0  3  0  0  0  3 
3  0 11  0  3  0 11  0  3  0 11  0  3  0 11  0  3  0 11  0  3  0 11  0  3 
3  0  3  0  3  0  3  0  8  0  3  0  3  0  3  0  8  0  3  0  3  0  3  0  3 
3  0  3  0  8  0  3  0  0  0  3  0  3  0  3  0  0  0  3  0  3  0  3  0  3 
3  0  3  0  0  0  3  0 11  0  3  0  8  0  3  0 11  0  3  0  8  0  3  0  3 
3  0  8  0 11  0  3  0  3  0  3  0  0  0  3  0  3  0  3  0  0  0  3  0  3 
3  0  0  0  3  0  8  0  3  0  8  0 11  0  8  0  3  0  8  0 11  0  8  0  3 
3  0  11 0  3  0  0  0  3  0  0  0  3  0  0  0  3  0  0  0  3  0  0  0  3 
3  0  8  0  7  2 10  0  7  2 10  0  7  2 10  0  7  2 10  0  7  2 10  0  3 
3  0  0  0  0  0  0  0  0  0  0  0  0  0  0  0  0  0  0  0  0  0  0  0  3 
7  2  2  2  2  2  2  2  2  2  2  2  2  2  2  2  2  2  2  2  2  2  2  2  6 
