4  2  2  2  5 99 99 99 99  4  2  5 99 99 99 99  4  2  5 99  4  2  2  2  5 
3  0  0  0  3 99 99 99 99  3 16  3 99 99 99 99  3 16  3 99  3  0  0  0  3 
3  0 11  0  7  2  2  2  2  6  0  7  2  2  2  2  6  0  7  2  6  0 11  0  3 
3  0  8  0  0  0  0  0  0  0  0  0  0  0  0  0  0  0  0  0  0  0  8  0  3 
3  0  0  0  4 10 99 99  9  5  0  4  2  2  2  2 10  0  9  2 10  0  0  0  3 
7  2  5  0  3 93 92 90 91  3  0  3  0  0  0  0  0  0  0  0  0  0 11  0  3 
99 99 3  0 13  2 12  2  2  6  0  3  0  9  2 12  5  0  9 10  0  9 15  2 14 
99 99 3  0  8  0  8  0  0  0  0  3  0  0  0  7  6  0  0  0  0  0  0  0  3 
99 99 3  0  0  0  0  0 11  0  0 13  2  5  0  0  0  0 11  0 11  0 11  0  3 
4  2  6  0  9  2  2  2 15 10  0  8  0  7  2  2 10  0  8  0  7  2  6  0  3 
3  0  0  0  0  0  0  0  0  0  0  0  0  0  0  0  0  0  0  0  0  0  0  0  3 
3  0 11  0  4  2  2  2  2  5  0  4  2  2  2  2  5  0  4  2  5  0 11  0  3 
3  0  8  0  3 99 99 99 99  3  0  3 99 99 99 99  3  0  3 99  3  0  8  0  3 
3  0  0  0  3 99 99 99 99  3 16  3 99 99 99 99  3 16  3 99  3  0  0  0  3 
7  2  2  2  6 99 99 99 99  7  2  6 99 99 99 99  7  2  6 99  7  2  2  2  6 
