25
4  2  2  2  2  2  2  2  2  2  2  2  2  2  2  2  2  2  2  2  2  2  2  2  5 
3  0  0  0  0  0  0  0  0  0  0  0  0  0  0  0  0  0  0  0  0  0  0  0  3 
3  0  4  2 10  0  9  2  2  2  2  2  2  2  2  2  2  2  2 10  0  9 10  0  3 
3  0  3 16  0  0  0  0  0  0  0  0  0  0  0  0  0  0  0  0  0  0  0  0  3 
3  0  3  0  4  2  2 10  0  9  2  2  2  2  2  2  2 10  0  9  2 10  0  0  3 
3  0  3  0  3 16  0  0  0  0  0  0  0  0  0  0  0  0  0  0  0  0  0  0  3 
3  0  3  0  3  0  4  2  2  2 10  0  9  2  2 10  0  9  2  2 10  0 11  0  3 
3  0  3  0  3  0  3 16  0  0  0  0  0  0  0  0  0  0  0  0  0  0  3  0  3 
3  0  8  0  3  0  3  0  4  2  2  2  2 10  0  9  2  2  2 10  0  9 14  0  3 
3  0  0  0  3  0  3  0  8  0  0  0  0  0  0  0  0  0  0  0  0  0  3  0  3 
3  0 11  0  3  0  8  0  0  0  9  2  2  2  2  2  2  2 10  0  9 12 14  0  3 
3  0  3  0  8  0  0  0  0  0  0  0  0  0  0  0  0  0  0  0  0 13 14  0  3 
3  0  8  0  0  0  9  2 10  0  4 10 99 99  9  5  0  0  9  2  2 15  6  0  3 
3  0  0  0  0  0  0  0  0  0  3 93 92 90 91  3  0  0  0  0  0  0  0  0  3 
7  2  2  2  2  2  2  2  2  2 15 2  2  2  2  15  2  2  2  2  2  2  2  2  6 
