4  2  2  2  2  2  2  2  2  2  2  2  2  2  2  2  2  2  2  2  2  2  2  2  5 
3  0  0  0  0  0  0  0  0  0  0  0  0  0  0  0  0  0  0  0  0  0  0  0  3 
3  0 11  0  4  2  2  2  2  5  0  4 10  0  4  2 12  2  2  2  5  0 11  0  3 
3  0  3  0  3 16  0  0  0  3  0  3  0  0  8  0  8  0  0 16  8  0  8  0  3 
3  0  8  0  7  2  2 10  0  3  0 13 10  0  0  0  0  0 11  0  0  0  0  0  3 
3  0  0  0  0  0  0  0  0  3  0  3  0  0  9  2  2  2 15  2  2  2  2  2 14 
3  0  9  2  2  2  2  2  2  6  0  7 10  0  0  0  0  0  0  0  0  0  0 16  3 
3  0  0  0  0  0  0  0  0  0  0  0  0  0  0  0  0  0  0  0  0  9 12 12 14 
13 2 10  0 11  0  4  2 12 12  2  2  2  2  2  2  2  2  2 10  0  0  7 15 14 
3  0  0  0  3  0  3 16  7  6  0  0  0  0  0  0  0  0  0  0  0  0  0  0  3 
3  0 11  0  8  0  3  0  0  0  0  4 10  0  4 10  0  4 10  0  4  5  0  9 14 
3  0  3  0  0  0  7 10  0 11  0  3  0  0  3  0  0  3  0  0 13  6  0  0  3 
3  0  8  0 11 99 99 99 99  3  0  7 10  0  7 10  0  7 10  0  8  0  0  4 14 
3  0  0  0  3 93 92 90 91  3  0  0  0  0  0  0  0  0  0  0  0  0  0 13 14 
7  2  2  2 15  2  2  2  2 15  2  2  2  2  2  2  2  2  2  2  2  2  2 15  6 
