25
4  2  2  2  2  2  2  2  2  2  2  2  2  2  2  2  2  2  2  2  2  2  2  2  5 
3  0  0  0  0  0  0  0  0  0  0  0  0  0  0  0  0  0  0  0  0  0  0  0  3 
3  0  4  2  2  2 10  0 11  0  9 10  0  9 10  0  9  2  5  0  9  2  5  0  3 
3  0  3 90 99  0  0  0  3  0  0  0  0  0  0  0 99 91  3  0 99 93  3  0  3 
3  0  3 99  4 10  0  9  6  0  4  2 10  0  9  2  5 99  3  0 11 99  3  0  3 
3  0  3  0  8  0  0  0  0  0  3  0  0  0  0  0  3  0  3  0  3  0  3  0  3 
3  0  8  0  0  0  4  2 10  0  3  0  4  2 10  0  3  0  7  2  6  0  8  0  3 
3  0  0  0  9  2 14 16  0  0  3  0  3  0  0  0  3  0  0  0  0  0  0  0  3 
3  0 11  0  0  0  7  2 10  0  3  0  8  0 11  0  3  0  4  2 10  0 11  0  3 
3  0  3  0 11  0  0  0  0  0  3  0  0  0  3  0  7  2  6  0  0  0  8  0  3 
3  0  3  0  7 10  0  9  5  0 13  2  2  2  6  0  0  0  0  0 11 99  0  0  3 
3  0  3  0  0  0  0  0  3  0  3  0  0  0  0  0  4  2  5  0  3 92 11  0  3 
3  0  7  2  2  2 10  0  8  0  8  0  9 10  0  9  6  0  7  2 15  2  6  0  3 
3  0  0  0  0  0  0  0  0  0  0  0  0  0  0  0  0  0  0  0  0  0  0  0  3 
7  2  2  2  2  2  2  2  2  2  2  2  2  2  2  2  2  2  2  2  2  2  2  2  6 
