4  2  2  2  2  2  2  2 12 12  2  2  2  2  2 12  2  2  2  2  2  2  2  2  5 
3  0  0  0  0  0  0  0  7 14  0  0  0  0  0  3  0  0  0  0  0  0  0  0  3 
3  0  4 10  0  9  5  0  0  8  0  9  2 10  0  3  0  9 12 10  0  9  5  0  3 
3  0  8  0  0 16  7  5  0  0  0  0  0  0 16  3  0  0  3  0  0 16  3  0  3 
3  0  0  0 11  0  0  3  0  4  2 10  0  9  2  6  0  9 15  2 10  0  3  0  3 
3  0 11  0  7  5  0  8  0  8  0  0  0  0  0  0  0  0  0  0  0  0  3  0  3 
3  0  3  0  0  8  0  0  0  0  0 11  0  4  5  0  4  2  2  2 10  0  8  0  3 
3  0  7 10  0  0  0 11  0  4  2  6  0  7  6  0  3  0  0  0  0  0  0  0  3 
3  0 99 99 99  0  9 14  0  8  0  0  0  0  0  0  8  0  9  5  0  9 10  0  3 
3  0 11 90 11  0  0  3  0  0  0 11  0  9 10  0  0  0  0  3  0  0  0  0  3 
3  0  3 92  7 10  0  3  0  9  2  6  0  0  0  0  4  2  2  6  0  9  5  0  3 
3  0  3 91 99  0  0  3  0  0  0  0  0 11  0  4  6  0  0  0  0  0  3  0  3 
3  0  8 93  9  2  2  6  0  4  2  2  2  6  0  8  0  0  9  5  0  9  6  0  3 
3  0 99 99 99  0  0  0  0  3 16  0  0  0  0  0  0  0  0  3  0  0  0  0  3 
7  2  2  2  2  2  2  2  2 15  2  2  2  2  2  2  2  2  2 15  2  2  2  2  6 
