25
4  2  2  2  2  2  2  2  2  2 12 12  2  2  2  2  2  2  2  2  2  2  2  2  5 
3  0  0  0  0  0  0  0  0  0  7  6  0  0  0  0  0  0  0  0  0  0  0  0  3 
3  0 11  0  4  2 10  0 11 99 99 99 99 11  0 11  0  9  2  2  5  0 11  0  3 
3  0  8  0  3 16  0  0 13 10 99 99  9 14  0  3  0  0  0 16  3  0  8  0  3 
3  0  0  0  8  0 11  0  3 93 92 90 91  3  0 13 12  2 10  0  8  0  0  0  3 
3  0 11  0  0  0  3  0  7  2  2  2  2  6  0  7  6  0  0  0  0  0 11  0  3 
3  0  7 10  0  9  6  0  0  0  0  0  0  0  0  0  0  0  0 11  0  9  6  0  3 
3  0  0  0  0  0  0  0 11  0  9  2 12 10  0 11  0 11  0  3  0  0  0  0  3 
3  0 11  0  4  2  2  2  6  0  0  0  8  0  0  7  2 15  2 15  5  0 11  0  3 
3  0  8  0  3  0  0  0  0  0 11  0  0  0  0  0  0  0  0  0  3  0  8  0  3 
3  0  0  0  7  5  0  9  2  2 15  2  5  0  9  2  2 10  0  4  6  0  0  0  3 
3  0  11 16 0  3  0  0  0  0  0  0  3  0  0  0  0  0  0  3  0 16 11  0  3 
3  0  7  10 0  7  2  2 10  0 11  0  8  0 11  0  9  2  2  6  0  9  6  0  3 
3  0  0  0  0  0  0  0  0  0  3  0  0  0  3  0  0  0  0  0  0  0  0  0  3 
7  2  2  2  2  2  2  2  2  2 15  2  2  2 15  2  2  2  2  2  2  2  2  2  6 
