25
4  2  2  2  2  2  2  2  2  2  2  2  2  2  2  2  2  2  2  2  2  2  2  2  5 
3  0  0  0  0  0  0  0  0  0  0  0  0  0  0  0  0  0  0  0  0  0  0  0  3 
3  0 11  0 11  0  9  2  2  2  2  2  2  2  2  2  2  2  5  0 11  0 11  0  3 
3  0  3  0  3  0  0  0  0  0  0  0  0  0  0  0  0  0  8  0  3  0  3  0  3 
3  0  8  0  3  0  9  2  2  2  2  2  2  2  2  2 10  0  0  0  3  0  8  0  3 
3  0  0  0  3  0  0  0  0  0  0  0  0  0  0  0  0  0  4  2  6  0  0  0  3 
3  0 11  0  7  2  5  0 11  0  4 10 99 99  9 12  5  0  3  0  0 16 11  0  3 
3  0  3  0  0 16  3  0  3  0  3 93 92 90 91 13 14  0  3  0  4  2  6  0  3 
3  0  7  2 10  0  8  0  8  0  7  2  2  2  2 15  6  0  8  0  8  0  0  0  3 
3  0  0  0  0  0  0  0  0  0  0  0  0  0  0  0  0  0  0  0  0  0  0  0  3 
3  0 11  0 11  0  9  2  2  2  2  2  2  2  2  2  2  2 10  0 11  0 11  0  3 
3  0  3  0  3  0  0  0  0  0  0  0  0  0  0  0  0  0  0  0  3  0  3  0  3 
3  0  8  0  8  0  9  2  2  2  2  2  2  2  2  2  2  2 10  0  8  0  8  0  3 
3  0  0  0  0  0  0  0  0  0  0  0  0  0  0  0  0  0  0  0  0  0  0  0  3 
7  2  2  2  2  2  2  2  2  2  2  2  2  2  2  2  2  2  2  2  2  2  2  2  6 
