25
4  2  2  2  2  2  2  2  2  2  2  2  2  2  2  2  2  2  2  2  2  2  2  2  5 
3  0  0  0  0  0  0  0  0  0  0  0  0  0  0  0  0  0  0  0  0  0  0  0  3 
3  0 11  0 11  0 11  0 11  0 11  0  0 11  0  4  2  2  2  2  2  2  5  0  3 
3  0 13  2 15  2 15  2 15  2 14  0  0  3  0  3  0  0  0  0  0  0  3  0  3 
3  0  3 99 99 99 99 99 99 99  3  0  0  3  0  3  0  4  2  2  5  0  3  0  3 
3  0  3 99 11 99 99  4  5 99  3  0  0  3  0  3  0  3 16  0  3  0  3  0  3 
3  0  3 99  7 10 99  7  6 99  3  0  0  3  0  3  0 13  5  0  3  0  3  0  3 
3  0  3 99 99 99 99 99 99 99  3  0  0  3  0  3  0 13 14  0  3  0  3  0  3 
3 99  3 99 99 99 99 99 99 99  3  0  0  3  0  8  0  7  6  0  3  0  3  0  3 
3 90  3 99 11 99 99 99 11 99  3  0  0  3  0  0  0  0  0  0  3  0  3  0  3 
3 92  3 99  7  2  2  2  6 99  3  0  0  3  0  9  2  2  2  2  6  0  3  0  3 
3 91  3 99 99 99 99 99 99 99  3  0  0  3  0  0  0  0  0  0  0  0  3  0  3 
3 93  7  2  2  2  2  2  2  2  6  0  0  7  2  2  2  2  2  2  2  2  6  0  3 
3 99  0  0  0  0  0  0  0  0  0  0  0  0  0  0  0  0  0  0  0  0  0  0  3 
7  2  2  2  2  2  2  2  2  2  2  2  2  2  2  2  2  2  2  2  2  2  2  2  6 
