4  2  2  2  2  2  2  2  2  2  2  2  2  2  2  2  2  2  2  2  2  2 12 12  5 
3  0  0  0  0  0  0  0  0  0  0  0  0  0  0  0  0  0  0  0  0  0  7 15 14 
3  0  0  0  4  2  2 10  0  9  2  2  2  2  2  2  2  2  2  2  5  0  0 16  3 
7  2  5  0  3 16  0  0  0  0  0  0  0  0  0  0  0  0  0  0  3  0  4  2  6 
99 99 3  0  3  0  4  2  2  2  2  2  2  2  2 10  0  9  5  0  3  0  3 99 99 
4  2  6  0  8  0  8  0  0  0  0  0  0  0  0  0  0  0  8  0  8  0  7  2  5 
3 16  0  0 99 99 99  0  4  2  2  2  2  2  2  2  5  0 99 99 99  0  0  0  3 
3  0  9  2  5 92 11  0  8  0  0  0  0  0  0  0  8  0 11 90  4  2 10  0  3 
3  0  0  0  3 91  3  0  0  0  4  2  2  2  5  0  0  0  3 93  3  0  0  0  3 
3  0 11  0  7  2  6  0 11  0  8  0  0  0  8  0 11  0  7  2  6  0 11  0  3 
3  0  3  0  0  0  0  0  3  0  0  0  0  0  0  0  3  0  0  0  0  0  3  0  3 
3  0  7  2 10  0 11  0  7  2  2  2  2  2  2  2  6  0 11  0  4  2  6  0  3 
3  0  0  0  0  0  8  0  0  0  0  0  0  0  0  0  0  0  8  0  8  0  0  0  3 
3  0 11  0 11  0  0  0 11  0 11  0 11  0 11  0 11  0  0  0  0  0 11  0  3 
7  2 15  2 15  2  2  2 15  2 15  2 15  2 15  2 15  2  2  2  2  2 15  2  6 
