4  2  2  2  2  2  2  2  2  2  2  2  2  2 12  2  2  2  2  2  2  2  2  2  5 
3  0  0  0  0  0  0  0  0  0  0  0  0  0  3  0  0  0  0  0  0  0  0  0  3 
3  0 11  0  4  2  2  2 10  0  9  2  2  2  6  0  9  2 10  0  9  2  5  0  3 
3  0  8  0  3 92 99  0  0  0  0  0  0  0  0  0  0  0  0  0 99 91  3  0  3 
3  0  0  0  8 99  4  2  2  2  2  2  2  2  2 10  0  9  2  2  5 99  3  0  3 
3  0 11  0  0  0  3  0  0  0  0  0  0  0  0  0  0  0  0  0  3  0  3  0  3 
3  0  3  0 11  0  3  0  4 10  0  9  2  2  2  2  2  2  5  0  8  0  8  0  3 
13 2 15  2  6  0  3  0  3  0  0  0  0  0  0  0  0  0  3  0  0  0  0  0  3 
3  0  0  0  0 99  8  0  7  2  2  2  2  2 10  0  9  2  6  0 11  0 11  0  3 
3  0 11  0 11 93 99  0  0  0  0  0  0  0  0  0  0  0  0  0  3  0  3  0  3 
3  0  3  0  7  2 10  0  9  2 12 10  0  9  2  2  2  2  2  2  6 99  3  0  3 
3  0  3  0  0  0  0  0  0  0  3  0  0  0  0  0  0  0  0  0 99 90  3  0  3 
3  0  7  2 10  0  9 12  2  2 15  2  2 10  0  9  2  2 10  0  9  2  6  0  3 
3  0  0  0  0  0  0  3 16  0  0  0  0  0  0  0  0  0  0  0  0  0  0  0  3 
7  2  2  2  2  2  2 15  2  2  2  2  2  2  2  2  2  2  2  2  2  2  2  2  6 
