25
4   2  2  2  2  2  2  2 12 12  2  2  2  2  2 12 12  2  2  2  2  2  2  2  5 
 3 93  99  99  99  0  0  0  7  6  0  0  0  0  0  7  6  0  0  0  0  0  0  0  3 
3 92  99  99  99  0 11  0  0  0  0 11  0 11 16  0  0  0 11  0  9  2  5  0  3 
3 91 11  99  99  0  3  0  4  2  2  6  0  7  2  2  5  0  3  0  0  0  3  0  3 
 3 90  3  0  4  2  6  0  3  0  0  0  0  0  0  0  3  0  7  2  5  0  8  0  3 
3  2  6  0  3  0  0  0  3  0  4  2  2  2  5  0  3  0  0  0  3  0  0  0  3 
 3  0  0  0  8  0  9  2  6  0  8  0  0  0  3  0  7  2 10  0  8  0 11  0  3 
 3 16 11  0  0  0  0  0  0  0  0  0 11  0  3  0  0  0  0  0  0  0  3  0  3 
13 2  6  0 11  0  9  2  5  0 11  0  8  0  8  0  4  2 10  0 11  0  8  0  3 
3  0  0  0  3  0  0  0  3  0  3  0  0  0  0  0  3  0  0  0  3  0  0  0  3 
3  0 11  0  7  2  5  0  8  0  3  0  0  0 11  0  8  0  4  2  6  0 11  0  3 
3  0  3  0  0  0  3  0  0  0 13  2 12  2 14  0  0  0  3  0  0 16  3  0  3 
3  0  7  2 10  0  8  0 11  0  8  0  8 16  8  0 11  0  8  0  9  2  6  0  3 
 3  0  0  0  0  0  0  0  3  0  0  0  0  0  0  0  3  0  0  0  0  0  0  0  3 
 7  2  2  2  2  2  2  2 15  2  2  2  2  2  2  2 15  2  2  2  2  2  2  2  6 

