4  2  2  2  2  2  2  2  2  2  2  2  2  2  2  2  2  2  2  2  2  2  2  2  5 
3  0  0  0  0  0  0  0  0  0  0  0  0  0  0  0  0  0  0  0  0  0  0  0  3 
3  0 11  0  0  0  9  2  2  2  5  0  4  2  2  2  2  2  2 10  0  9 10  0  3 
3  0  7  2  5  0  0  0  0  0  8  0  3 16  0  0  0  0  0  0  0  0  0  0  3 
3  0  0  0  3  0 11  0  0  0  0  0  3  0 11 90 11 92 11 91 11 93 11  0  3 
13 2 10  0  8  0  7  2  2  2  5  0  3  0  7  2 15  2 15  2 15  2 14  0  3 
3  0  0  0  0  0  0  0  0  0  3  0  3  0  0  0  0  0  0  0  0  0  3  0  3 
3  0  9  2  2  2  2  2 10  0  8  0  7  2  2 10  0  9  2 10  0  9 14  0  3 
3  0  0  0  0  0  0  0  0  0  0  0  0  0  0  0  0  0  0  0  0  0  3  0  3 
3  0  9  2  2  2  5  0 11  0  0  0  0  4  2  5  0  9 12  2  5  0  8  0  3 
3  0  0  0  0  0  3  0  7  2  2  2  2  6  0  3  0  0  3  0  8  0  0  0  3 
3  0  4 12  5  0  3  0  0  0  0  0  0  0  0 13 10  0  3  0  0  0 11  0  3 
3  0  7 15  6  0  7  2  2  2  5  0  9  2  2  6  0  0  7  2  2  2  6  0  3 
3  0  0  0  0  0  0  0  0  0  3  0  0  0  0  0  0  0  0  0  0  0  0  0  3 
7  2  2  2  2  2  2  2  2  2 15  2  2  2  2  2  2  2  2  2  2  2  2  2  6 
