4  2  2  2  2  2  2  2  2  2  2  2  2  2  2  2  2  2  2  2  2  2  2  2  5 
3  0  0  0  0  0  0  0  0  0  0  0  0  0  0  0  0  0  0  0  0  0  0  0  3 
3  0  4  5  0  9  2  2  2  2 10  0  0  0  0  0  9  2  2 10  0  4  5  0  3 
3  0  7  6  0  0  0  0  0  0  0  0  0  4  5  0  0  0  0  0  0  7  6  0  3 
3  0  0  0  0 11 99 99 99 99 11  0  0  7  6  0  0  0  0  0  0  0  0  0  3 
3  0 11  0  0  3 99  4  5 99  3  0  0  0  0  0  4 12  5  0  0 11  0  0  3 
3  0  3  0  0  3 90  3  3 92  3  0  0  4  5  0 13 15 14  0  0  3  0  0  3 
3  0  3  0  0  3 91  3  3 93  3  0  0 13 14  0  3 16  3  0  0  3  0  0  3 
3  0  3  0  0 13 12 15 15 12 14  0  0 13 14  0  3  0  7 12 12 14  0  0  3 
3  0  8  0  0  7  6  0  0  7  6  0  0  7  6  0  8  0  0  7 15  6  0  0  3 
3  0  0  0  0  0  0  0  0  0  0  0  0  0  0  0  0  0  0  0  0  0  0  0  3 
3  0  4  5  0  0  0  0  0  0  0  0  0  0  0  0  0  0  0  0  0  4  5  0  3 
3  0  7  6  0  9  2  2  2  2  2  2  2  2  2  2  2  2  2 10  0  7  6  0  3 
3  0  0  0  0  0  0  0  0  0  0  0  0  0  0  0  0  0  0  0  0  0  0  0  3 
7  2  2  2  2  2  2  2  2  2  2  2  2  2  2  2  2  2  2  2  2  2  2  2  6 